background=galaxy.png

STELLAR DAWN
0a0a0a0a0
b0b0b0b0b
0c0c0c0c0
dd0dd0dd0

LUNAR RISE
0b0b0b0b0
c0c0c0c0c
0d0d0d0d0
0a0aa0a0a

NEBULA SHADOWS
c0c0c0c0c
0b0b0b0b0
dd0dd0dd0
0a0a0a0a0

COSMIC STORM
0d0d0d0d0
c0c0c0c0c
0b0b0b0b0
0a0a0a0a0

SUPERNOVA BLAST
0aa00aa00
0c0cc0c0c
bb0bbb0bb
00dd00dd0

GALAXY'S EDGE
a0a0a0a0a
0b0b0b0b0
c0c0c0c0c
d0d0d0d0d